11111111111111111111111
1E00000001111100C000C11
10100101000000000000001
10100100000000000010101
1P000000000000000000001
10000000000000000000001
10000000000000000000001
10000000000000000000011
11111111111111111111111