11111111111111111111111
1E00000001111100C000C11
10100101111111111000001
10100100111111111010101
1P000000111111111000001
10000000111111111000001
10000000111111111000001
10000000111111111000001
11111111111111111111111