111111111
1E00000C1
101001011
101001001
1P0000001
111111111