11111111111111111
1E000000000C000C1
10100101001000001
10100100101010101
1P0000000C00C0001
11111111111111111