111111111
1E00000C1
100001011
101001001
1P0100001
111111111