11111111111
10000111111
10E1011EE11
1010C111111
10P00111111
11111111111