11111111111
100000E0001
10100101001
10100100101
100C00000P1
11111111111