1111111111111111111111111111111111
100000000000000C00000C000000000001
1010010100100000101001000000010101
10100100101010100010010E0000010101
1P0000000C00C000000000000000000C11
1111111111111111111111111111111111